A ###################
    #   #           #
# ##### # ####### ###
#   #         #     #
# ##### ####### # ###
#         # #   #   #
### ####### ### ### #
#   #   #       #   #
# ### # # # ### ### #
#   # #   #   # #    
################### B