A  ####################################################################################################
                     #           #     #                       #  #  #        #     #  #     #  #     #
#  #  ####  #############  ##########  #  #############  #  #  #  #  #######  ####  #  #  ####  ####  #
#  #     #     #        #  #     #     #     #     #     #  #           #     #     #  #  #           #
#######  ####  ####  ####  #  #######  #  ####  #  #  #######  ##########  ####  ####  #  #  ##########
#  #  #  #              #  #     #              #  #  #  #     #  #           #     #  #        #  #  #
#  #  #  #######  #######  #  #  #  ####  #  #  #  ####  #######  #######  #######  #  #  #######  #  #
#  #        #  #        #     #     #     #  #  #     #           #           #  #  #     #     #     #
#  ####  #  #  #  #  ####  #  #  ####  #  #  ##########  #  #  #  #  ##########  #  #  ####  #  #  #  #
#  #     #     #  #     #  #  #  #  #  #  #     #  #  #  #  #  #           #     #           #     #  #
#  #  ################  #  #  #  #  ####  #######  #  ##########  ####  #######  ####  #######  #  #  #
#  #                 #  #  #  #  #     #     #           #     #     #           #     #  #     #  #  #
#  #  #  ####  ####  #######  ####  #############  ####  ####  #######  ####  ####  #  #  #######  ####
#     #  #     #           #     #     #  #     #  #     #  #  #        #        #  #     #        #  #
#  ################  ####  #  #  #  ####  ####  #  ####  #  #  #############  ####  ################  #
#  #                 #  #  #  #     #        #     #                    #           #  #  #  #        #
#  ####  ##########  #  ####  ##########  #############  #######  #  #  ####  #######  #  #  ####  ####
#     #        #        #                       #        #        #  #  #           #                 #
##########  ##########  #  ##########  ####  ####  ####  #  ################  ####  ####  ####  #######
#                 #           #  #        #        #     #     #        #     #     #     #     #     #
#  #  #######  #######  #  ####  ####  ####  ###################  ##########  #############  ####  ####
#  #  #  #  #  #        #     #  #     #  #        #  #           #           #  #                    #
#  #  #  #  #######  ####  ####  #######  #  ####  #  #######  #  #######  #  #  #  ################  #
#  #        #     #     #        #     #        #  #           #  #     #  #  #     #  #     #        #
#######  ####  ####  ####  ##########  ####  ####  #  #############  #  #  #  #######  #  ####  #  #  #
#     #        #     #  #  #  #     #  #  #  #     #        #  #  #  #     #     #     #        #  #  #
####  ##########  ####  ####  #  #  #  #  #  ####  #  ####  #  #  #  #  #######  ####  ##########  #  #
#     #  #        #  #     #  #  #              #  #  #              #  #           #     #  #  #  #  #
####  #  #  ####  #  #  ####  #############  #######  #  #  #  #########################  #  #  #  #  #
#        #  #              #  #  #              #     #  #  #                    #           #  #  #  #
#  ####  #######  #  #  ####  #  #######  ####  ####  #######  #  #  ##########  ##########  #  #  ####
#     #           #  #  #  #        #        #  #        #  #  #  #        #                    #     #
#  ####  ####  #  ####  #  ####  #  ######################  #  ####  ####  #  ####  #  #######  #  #  #
#  #  #     #  #  #  #        #  #        #     #           #     #  #     #     #  #     #  #  #  #  #
####  #  #  #######  #  #  #  #  ##########  ####  ##########  #  #  #  #  #############  #  ####  #  #
#     #  #  #        #  #  #        #     #           #  #     #  #  #  #  #                       #  #
#  #  #  #  #######  #######  ####  #  ####  ##########  #  ####  #############  ####  ####  ####  ####
#  #  #  #              #        #     #     #           #     #        #     #     #  #  #     #     #
#  #  ####  #######  #  #  #  #  ####  #  #######  #######  ################  #  ####  #  ####  ####  #
#  #        #        #  #  #  #  #              #  #        #  #  #     #     #  #     #  #     #     #
##########  #  #  ################  ####  ####  #  ##########  #  ####  ####  #  #  ####  ####  ####  #
#        #  #  #     #              #     #           #           #        #     #  #           #     #
#######  #  #############  ####  ####  #  #######  #######  #  #######  ############################  #
#  #  #        #     #     #        #  #        #  #        #  #     #  #  #     #  #        #  #     #
#  #  #  ####  #  #############  ################  #  ####  ####  #  #  #  ####  #  #######  #  #  ####
#  #  #  #     #  #     #  #     #     #     #        #  #  #     #        #  #  #              #     #
#  #  #  #######  ####  #  #  ####  #  #  ##########  #  #  ####  ####  ####  #  ##########  #######  #
#     #     #     #  #     #  #  #  #           #     #  #        #           #        #     #  #     #
#  ##########  #  #  #  #######  ##########  ##########  ####  ##########  #######  ####  ####  #  ####
#           #  #     #           #        #        #     #  #     #  #  #           #        #        #
#######  #  #  ####  ####  ####  #  #  ####  ##########  #  #  #  #  #  #  #  ####  #  ####  #  #######
#  #     #        #           #  #  #     #  #  #  #  #  #     #  #     #  #     #  #  #     #  #     #
#  ####  ##########  ####  ##########  #  #  #  #  #  #  ####  ####  #  #  #  #######  #######  #  ####
#  #     #  #     #  #  #  #     #  #  #  #  #                 #  #  #  #  #  #  #  #        #  #     #
#  ####  #  #  #######  ####  ####  #  #  #  ####  #  #  #######  #  #######  #  #  #  #  ####  #  #  #
#  #                 #     #  #  #  #  #        #  #  #  #  #        #  #     #        #  #  #     #  #
#  #  #######  #  ####  ####  #  #  #######  ####  ####  #  #  #######  #  #######  #######  #  #  #  #
#  #  #  #  #  #  #  #        #  #        #     #  #              #                 #           #  #  #
#  ####  #  ####  #  #  #######  #  ####  ####  ####  ####  #  #######  ####  ####  #######  ####  ####
#  #  #        #  #  #  #           #        #  #        #  #        #     #  #           #  #        #
#  #  ####  #  #  #  #  ####  #  ##########  #  #############  #  #  ####  ####  #######  #  ####  ####
#           #                 #     #           #     #        #  #     #  #  #  #     #     #  #     #
#############  #  ####  ##########  #  #  ####  #  ####  ####  ####  ####  #  #######  #  #  #  ####  #
#              #  #        #        #  #  #                 #     #     #           #     #  #         
####################################################################################################  B