# ###################
#     #     #       #
# ##  # ### # ##### #
# #   #   #   # #   #
# ####### ### # # ###
#   #   #   #   # # #
### # ###   ##### # #
#     #   #   #     #
# ##### # ##### #####
#       #   #       #
################### #