A  ############################
      #                 #     #
####  ####  #  ##########  #  #
#           #           #  #  #
#######  #############  ####  #
#     #     #              #  #
#  ####  #######  #  #######  #
#        #        #           #
#  ####  ####  #######  ####  #
#     #     #        #     #  #
#######  ####  #  #  #######  #
#           #  #  #  #  #  #  #
#######  ####  ####  #  #  #  #
#     #  #     #  #     #  #  #
#  ##########  #  ####  #  #  #
#  #     #  #  #           #  #
#  #  #  #  ####  ####  #  #  #
#     #  #     #     #  #  #  #
#  ####  #  #  #  #  #  #  ####
#     #     #     #  #  #      
############################  B